MT-ATP6	Heavy
MT-ATP8	Heavy
MT-CO1	Heavy
MT-CO2	Heavy
MT-CO3	Heavy
MT-CYB	Heavy
MT-ND1	Heavy
MT-ND2	Heavy
MT-ND3	Heavy
MT-ND4	Heavy
MT-ND4L	Heavy
MT-ND5	Heavy
MT-ND6	Light
MT-RNR1	Heavy
MT-RNR2	Heavy
MT-TA	Light
MT-TC	Light
MT-TE	Light
MT-TF	Heavy
MT-TG	Heavy
MT-TH	Heavy
MT-TI	Heavy
MT-TL1	Heavy
MT-TL2	Heavy
MT-TM	Heavy
MT-TP	Light
MT-TQ	Light
MT-TR	Heavy
MT-TS1	Light
MT-TS2	Heavy
MT-TV	Heavy
MT-TW	Heavy
MT-TY	Light
